                                                                                                                                                      
                                                                                                                                                      
                                                                                                                                                      
                                                                                                                                                      
                                                                                                                                                      
                                                                                                                                                      
                                                                                                                                                      
                                                                                                                                                      
                                                                                                                                                      
                                                                                                                                                      
                                                                                                                                                      
                                                                                                                                                      
                                                                                                                                                      
                                                                                                                                                      
                                                                                                                                                      
                                                                                                                                                      
                                                                                                                                                      
                                                                                                                                                      
                                                                                                                                                  ****
                                                                                                                                            **********
                                                                                                                                        **************
                                                                                                                                   *******************
                                                                                                                               ***********************
                                                                                                                           ***************************
                         ***                                                                                            ******************************                                                                                                                          
                       *******                                                                                        ********************************                                                                                                                        
                   ************                                                   ****************                  **********************************
               *****************                                             ***************************           ***********************************
             ********************                                          ********************************      *************************************
         *************************                                       ************************************   **************************************
     ******************************                                   ********************************************************************************
************************************               ***              **********************************************************************************
**************************************            ******         *************************************************************************************
****************************************        ***********     **************************************************************************************
*******************************************   **************    **************************************************************************************
******************************************************************************************************************************************************
******************************************************************************************************************************************************
******************************************************************************************************************************************************
******************************************************************************************************************************************************
******************************************************************************************************************************************************