                                                                                                                                                      
                                                                                                                                                      
                                                                                                                                                      
                                                                                                                                                      
                                                                                                                                                      
                                                                                                                                                      
                                                                                                                                                      
                                                                                                                                                      
                                                                                                                                                      
                                                                                                                                                      
                                                                                                                                                      
                                                                                                                                                      
                                                                                                                                                      
                                                                                                                                                      
                                                                                                                                                      
                                                                                                                                                      
                                                                                                                                                      
                                                                                                                                                      
                                                                                                                                                      
                                                                                                                                                      
                                                                                             *******************                                                                                                                                                                                                 
                                                                                             *******************                                                                                                                                                                                                  
                                                                                             *******************                                                                                                                                                                                                 
                                                                                             *******************                                                                                                                                                                                                  
                                                                                    *************************************         ********************                                                                                                                                                                                                                                                                                     
                                                                                    *************************************         ********************                                                                                                                                                                                                                                                                                     
                                                                                    *************************************         ********************                                                                                                                                                             
                                                                                    *************************************         ********************                                                                                                                                                             
                                                                           ***************************************************************************
*********                                                                  ***************************************************************************
*********                                                                  ***************************************************************************       
*********                                                                  ***************************************************************************                                                                                                                                                     
*********                                                         ************************************************************************************                                          
******************                                                ************************************************************************************
******************                                                ************************************************************************************
******************                                                ************************************************************************************
******************************************************************************************************************************************************
******************************************************************************************************************************************************
******************************************************************************************************************************************************
******************************************************************************************************************************************************